0000000000
0xxxx00000
0000x00000
0000x00000
0000x00000
0000x0x000
0000x0xx00
0000x0xxx0
0000x0xxx0
000xxxx000